32 32
################################
#..............................#
#.####.####...###..............#
#.#..#.#..#.###.###............#
#.#.......#.#.....#............#
#.#.......#.##...##............#
#.#.......#.#.....#............#
#.#####...#.##...##............#
#.....#...#.#.....#.#..........#
#.###.#...#.###.###.#..........#
#.#...#####...#.#...#..........#
#.###..............##..........#
#......#####...........####....#
#.#.#..#...........#####..##.#.#
#.#.#..#####...............#.#.#
#.###..#...........#####..##...#
#......#####...........####....#
#.#.#..............###.........#
#.#.##.#######...###.###.#####.#
#.#....#.....#...#.....#.##..#.#
#.#.##.#.....#...#.#.#.#.....#.#
#.#.#..#.....#...###.###.#####.#
#......#.#.#.#.................#
#.####.###.###...#############.#
#.#..............#.....#.##..#.#
#.####..#####....##..........#.#
#.#....##...##....###....#####.#
#.####.#.....................#.#
#.#....##...##....##.#.#.##..#.#
#.####..#####....#####.#######.#
#..............................#
################################